*************
*s    *     *
* *** * *** *
* *   *   * *
* ******* ***
*           *
*** * *** * *
*     *   * *
* ********* *
*          f*
*************
